  _                   _   _____ 
 | |    _____   _____| | |___  |
 | |   / _ \ \ / / _ \ |    / / 
 | |__|  __/\ V /  __/ |   / /  
 |_____\___| \_/ \___|_|  /_/   

You made it till here. Don't wase your chance...
