  _                   _   _  _   
 | |    _____   _____| | | || |  
 | |   / _ \ \ / / _ \ | | || |_ 
 | |__|  __/\ V /  __/ | |__   _|
 |_____\___| \_/ \___|_|    |_|  
                                 
You know elbeyet in CyberCup is not beyet ;)
