  _                   _    __   
 | |    _____   _____| |  / /_  
 | |   / _ \ \ / / _ \ | | '_ \ 
 | |__|  __/\ V /  __/ | | (_) |
 |_____\___| \_/ \___|_|  \___/ 
                                
maths maths maths ...
