
 ▄████▄   ▒█████   ███▄    █   ▄████  ██▀███   ▄▄▄     ▄▄▄█████▓▒███████▒
▒██▀ ▀█  ▒██▒  ██▒ ██ ▀█   █  ██▒ ▀█▒▓██ ▒ ██▒▒████▄   ▓  ██▒ ▓▒▒ ▒ ▒ ▄▀░
▒▓█    ▄ ▒██░  ██▒▓██  ▀█ ██▒▒██░▄▄▄░▓██ ░▄█ ▒▒██  ▀█▄ ▒ ▓██░ ▒░░ ▒ ▄▀▒░ 
▒▓▓▄ ▄██▒▒██   ██░▓██▒  ▐▌██▒░▓█  ██▓▒██▀▀█▄  ░██▄▄▄▄██░ ▓██▓ ░   ▄▀▒   ░
▒ ▓███▀ ░░ ████▓▒░▒██░   ▓██░░▒▓███▀▒░██▓ ▒██▒ ▓█   ▓██▒ ▒██▒ ░ ▒███████▒
░ ░▒ ▒  ░░ ▒░▒░▒░ ░ ▒░   ▒ ▒  ░▒   ▒ ░ ▒▓ ░▒▓░ ▒▒   ▓▒█░ ▒ ░░   ░▒▒ ▓░▒░▒
  ░  ▒     ░ ▒ ▒░ ░ ░░   ░ ▒░  ░   ░   ░▒ ░ ▒░  ▒   ▒▒ ░   ░    ░░▒ ▒ ░ ▒
