  _                   _   ____  
 | |    _____   _____| | | ___| 
 | |   / _ \ \ / / _ \ | |___ \ 
 | |__|  __/\ V /  __/ |  ___) |
 |_____\___| \_/ \___|_| |____/ 
                                
A twisty RSA ...
